 0 0 0 0 Y 0 0
 0 0 0 0 1 1 P
 0 0 0 0 1 1 0
 0 0 0 1 1 1 0
 0 0 0 1 0 R 0
 0 0 0 0 0 0 0
 0 0 0 0 0 0 0
 