 0 0 0 0 0 0 0
 0 0 0 R 0 0 0
 0 1 1 1 0 0 0
 0 1 1 B P 0 0
 0 1 1 1 1 Y 0
 0 0 0 0 0 0 0
 0 0 0 0 0 0 0
 